......s...
..........
..........
..........
....#...##
....#...#.
..###...#.
........#.
........#.
#########.

...................................................s.....
.........................................................
.........................................................
.........................................................
.........................................................
.........................................................
.........................................................
.........................................................
.........................................................
.........................................................
.........................................................
.........................................................
.........................................................
.................................................#...#...
.................................................#...#...
.................................................#...#...
.................................................#...#...
................................................##...####
................................................#.......#
................................................#.......#
................................................#.......#
................................................#.......#
................................................#.......#
................................................#.......#
................................................#########
.........................................................
.........................................................
.............................................#####.......
.........................................................
.........................................................
..........................................#####.#####....
.........................................................
.........................................................
.......................................#####.#####.#####.
.........................................................
.........................................................
.......................................#.................
.................................#######.................
.........................................................
.........................................................
.........................................................
...................................#..........#..........
...................................############..........
.........................................................
.........................................................
.............................................#####.......
.........................................................
.........................................................
..........................................#####.#####....
.........................................................
.........................................................
.......................................#####.#####.#####.
.........................................................
.........................................................
.......................................#.................
...................................#...#.#...............
...................................#...#.#...............
...................................#...#.#...............
...................................#.#.#.#...............
.................................#.#.#.#.#...............
.................................#.#.#.#.#...............
.................................#.#.#.#.#...............
.................................#.#.#.#.#...............
.................................#.#.#.#.#...............
.................................#########...............
.........................................................
.........................................................
.........................................................
.........................................................
......................................#..................
............................###########..................
.........................................................
.........................................................
........................#...#............................
........................#...#............................
........................#...#............................
........................#...#............................
.................########...#########....................
.................#..................#....................
.................#..................#....................
.................#..................#....................
.................#..................#....................
.................####################....................
.........................................................
.........................................................
.............#...#.......................................
.............#...#.......................................
.............#...#.......................................
.....#########...#####...................................
.....#...............#...................................
.....#...............#...................................
.....#...............#...................................
.....#...............#...................................
.....#...............#...................................
.....#################...................................
.........................................................
.........................................................
.......................#.................................
.......................#.................................
.......................#.................................
...................#...#.................................
...................#...#.................................
...................#...#.................................
...................#...#.................................
...................#.#.#.................................
...................#.#.#.................................
...................#.#.#.................................
...................#####.................................
.........................................................
.........................................................
.........................................................
.........................................................
.............#...........................................
.............#...........................................
.............#.#.........................................
.............#.#.........................................
.............#.#.........................................
.............#.#.........................................
.............#.#...#.....................................
.............#.#.#.#.#...................................
.............#########...................................
.........................................................
.........................................................
...................#....#................................
...................#....#................................
...................#....#................................
...................#....#................................
...........#########....##...............................
...........#.............#...............................
...........#.............#...............................
...........#.............#...............................
...........#.............#...............................
...........###############...............................
.........................................................
.........................................................
.........................................................
.........................................................
.................#.......................................
.................###################.....................
.........................................................
.........................................................
.........................................................
.......................................#.................
.......................................#.................
...................................#...#.................
...............................#...#...#.................
...............................#...#...#.................
...............................#...#...#.................
...............................#...#.#.#.................
...............................#...#.#.#.................
...............................#.#.#.#.#.................
...............................#########.................
.........................................................
.........................................................
...........................######........................
.........................................................
........................######.######....................
.........................................................
.....................######.######.######................
.........................................................
..................######.######.######.######............
.........................................................
...............######.######.######.######.######........
.........................................................
.........................................................
............#####........................................
.........................................................
.........#####.#####.....................................
.........................................................
......#####.#####.#####..................................
.........................................................
...#####.#####.#####.#####...............................
.........................................................
#####.#####.#####.#####.#####............................